..............................
#......................#......
.......................#......
.......................#......
.......................#......
.......................#......
....####################......
....#.........................
....#.........................
....#........................#
....#.........................
....#.........................
......................###.....
........................#.....
........................#.....
.......#######................
..........#...................
..............................
..............................
..............................
..............................
..............................
..............................
..............................
..............................
..............................
..............................
..............................
..........................#...
......................########