..............................
..............................
..............#...............
..............#...............
..#...........#............#..
..#...........#............#..
..#...........#............#..
..#...........#............#..
..#....################....#..
..#........................#..
..#........................#..
..#....################....#..
..#...........#............#..
..#...........#............#..
..#...........#............#..
..#...........#............#..
..#...........#............#..
..#...........#............#..
..#...........#............#..
..............#...............
..............#...............
..............#...............
..............#...............
..............#...............
..............#...............
..............#...............
..............#...............
..............#...............
..............................
..............................