..............................
...#......................#...
...#..####................#...
...#................####..#...
...#..####................#...
...#................####..#...
...#..####................#...
...#................####..#...
...#..####................#...
...#................####..#...
...#..####................#...
...#................####..#...
...#..####................#...
...#................####..#...
...#..####................#...
...#................####..#...
...#..####................#...
...#................####..#...
...#..####................#...
...#................####..#...
...#..####................#...
...#................####..#...
...#..####................#...
...#................####..#...
...#..####................#...
...#................####..#...
...#..####................#...
...#................####..#...
...#..####................#...
..............................