..............................
...########################...
..............................
..............................
...########################...
..............................
..............................
...########################...
....#....................#....
..............................
...########################...
...###........##........###...
...##.........##.........##...
...#..........##..........#...
...#..........##..........#...
...#..........##..........#...
...#..........##..........#...
...#..........##..........#...
...#..........##..........#...
...#....#.....##.....#....#...
........#............#........
........#............#........
........#............#........
........#............#........
........#............#........
........#............#........
..............................
..............................
..............................
..............................