..............................
..............................
..............................
..............................
..............................
..............................
..............................
..............................
..............................
..............................
..............................
..............................
..............##..............
.............####.............
...........########...........
......##################......
.....####################.....
....######################....
...########################...
....######################....
.....####################.....
......##################......
.........###########..........
..............................
..............................
..............................
..............................
..............................
..............................
..............................