........##############........
............######............
###........................###
.......#..............#.......
.......#..............#.......
.......#..............#.......
.......#..............#.......
.......#..............#.......
.......################.......
..............................
..............................
.......################.......
.......#......................
.......#......................
.......#......................
.......#......................
.......#......................
.......################.......
.......#..............#.......
.......#..............#.......
.......#..............#.......
.......#..............#.......
.......#..............#.......
..............................
...##....................##...
...##...##############...##...
...##....................##...
...##....................##...
...########################...
..##########################..