..............................
..............................
..............................
..............................
..............................
..............................
.......#..............#.......
.......#..............#.......
.......#..............#.......
.......#..............#.......
.......#..............#.......
.......################.......
.........############.........
............#######...........
..............###.............
...............#..............
..............................
..............................
..............................
..............................
..............................
..............................
..............................
..............................
..............................
..............................
..............................
..............................
..............................
..............................